########
#   *  #
#@ --  #
#---   #
#*  ---#
########
